11111111111111111111111111
1001000C0000000000000000C1
10000111110000000C00000001
10000100010000C00000000001
10000100010C00000000000001
100001000100000C0000000001
100001000100C000000C000001
1P0011E000000C00000000C001
11111111111111111111111111