111111111
100CEP001
100000001
100000001
100000001
100000001
100000001
111111111