111111111111111111111
1001000C00000000000C1
10000111110000000C001
10000100010000C000001
10000100010C000000001
100001000100000C00001
100001000100C000000C1
1P0011E000000C000C001
111111111111111111111