111111111
100000C01
10P000001
10C000E01
100000001
111101111
111101111
100000C01
10P000001
10C000E01
100000001
111111111